1111111111
10000000C1
1000000001
1000000001
1001000001
1P1E0CCC11
100100C001
1111111111
